::Aha, why isn't this preserved
Collection: TheComet
Author: TheComet
Copyright (c) TheComet
These levels may be freely distributed provided they are credited with
the author's name.

Chaos

#######
###p .#
# b #.#
#  bb #
#.  # #
#   b.#
#######

Demo Level 01

########
#      #
#@ $   #
#   $  #
# . .  #
########

Solution/Moves
dDuurrddLLrrddLLUlluuRDRddrruuLLrruullDlldddRRuULrrruullDldRddlUruuurr
ddddLLuuRlddrruUUdlldlldRRuuulDrddlluRurrrddLLUluRRlddrruUlldlldRRRllu
uulD